SO asset/xpm/SKY_BLACK.xpm
WE asset/xpm/SKY_BLACK.xpm
NO asset/xpm/SKY_BLACK.xpm
EA asset/xpm/SKY_BLACK.xpm

F 220,100,0
C 225,30,0

11101111
1000N001
11111111
