SO asset/xpm/SKY_BLACK.xpm
WE asset/xpm/SKY_BLACK.xpm
NO asset/xpm/SKY_BLACK.xpm
EA asset/xpm/SKY_BLACK.xpm

F 220,100,0
C 225,30,0

11111111
10000001
10011001E
10000001
10000001
10000001
11111111
