SO asset/SO.xpm
WE asset/WE.xpm
NO asset/NO.xpm
EA asset/EA.xpm
F 140,139,139
C 154,209,230
11111111111111111          11111111111111111
10000010000000001          10000000000000001
100N0010000001001          10000011110000001
10000000000001001          10000000000000001
1111111111000000111 111111110000011111111111
         1000000001 10000000000001
         1000000001 10000 00000001
         1111111111 11111111111111
