SO asset/xpm/pokewall.xpm
WE asset/xpm/pokewall.xpm
NO asset/xpm/pokewall.xpm
EA asset/xpm/pokewall.xpm
F 140,139,139
C 154,209,230

11111111111111111          11111111111111111
10000010000000001          10000000000000001
10000010000001001          10000011110000001
100E0020000001001          10000000000000001
1111111111001000111 111111110000011111111111
         1000000001110000000000001
         1000000000000000000000001
         1111111111111111111111111
