SO asset/xpm/SO.xpm
WE asset/xpm/WE.xpm
NO asset/xpm/NO.xpm
EA asset/xpm/EA.xpm
F 140,139,139
C 154,209,230

11111111111111111          11111111111111111
10000010000000001          10000000000000001
100E0010000001001          10000011110000001
10000000000001001          10000000000000001
1111111111000000111 111111110000011111111111
         1000000001 10000000000001
         1000000001 10000000000001
         1111111111 11111111111111
