SO asset/xpm/SO.xpm
WE asset/xpm/WE.xpm
NO asset/xpm/NO.xpm
EA asset/xpm/EA.xpm
F 140,139,139
C 154,209,230

11111 11111
10001 10001
10W01 11111
10001
11111