SO asset/xpm/planet.xpm
WE asset/xpm/planet.xpm
NO asset/xpm/planet.xpm
EA asset/xpm/sky_black.xpm
F 166,166,166
C 23,22,40

11111111111
10000000001
10000000001
10001000001
10001000W01
10001000001
10001000001
10000000001
10000000001
11111111111
