SO asset/xpm/SO.xpm
WE asset/xpm/WE.xpm
NO asset/xpm/NO.xpm
EA asset/xpm/EA.xpm
F 220,100,0
C 225,30,0

11111111111
10000000001
10000000001
10001000001
10001000W0111111
10001000001
10001000001
10000000001
10000000001
11111111111
