SO asset/xpm/SO.xpm
WE asset/xpm/WE.xpm
NO asset/xpm/NO.xpm
EA asset/xpm/EA.xpm
F 220,100,0
C 225,30,0
111111111111111111111111111
10000001000000010000010E111
100000010001100101000100111
100000010001100101000000111
100000000001100001111111111
111111111111111001111111111
100001000000010000000111111
111100000000000000000001111
111111111111111111111111111
