SO asset/xpm/SO.xpm
WE asset/xpm/WE.xpm
NO asset/xpm/NO.xpm
EA asset/xpm/EA.xpm
F 140,139,139
C 154,209,230

1111111
1011101
1010101
101N100
1011101
1111111
