SO textures/map2/SO.xpm
WE textures/map2/WE.xpm
NO textures/map2/NO.xpm
EA textures/map2/EA.xpm
F 140,139,139
C 154,209,230
11111111111111110          11111111111111111
10000010000000001          10000000000000001
100N0010000001001          10000011110000001
10000000000001001          10000000000000001
11111111110000001111111111110000011111111111
         1000000000000000000000001
         1000000000000000000000001
         1111111111111111111111111
