1111111111
1000000001
1000000001
1000100001
10001000W1
1000100001
1000100001
1000000001
1000000000
1111111111
