SO asset/xpm/SO.xpm
WE asset/xpm/WE.xpm
NO asset/xpm/NO.xpm
EA asset/xpm/EA.xpm
F 140,139,139
C 154,209,230


111111 111111                               1111111111
100N01 100001 111111111                     1000000001
100001 100001 100000001                     1000000001
111111 111111 111111111       111111        1000000001
                              100001        1000000001
                              111111        1000000001
    11111111                                1000000001
    10000001                                1000000001
    11111111 1111                           1000000001
             1001                           1000000001
             1111                           1000000001
                        111111              1000000001
                        100001              1000000001                111111
                        111111              1000000001                100001
                                            1111111111                111111