SO asset/xpm/SO.xpm
WE asset/xpm/WE.xpm
NO asset/xpm/NO.xpm
EA asset/xpm/EA.xpm
F 140,139,139
C 154,209,230


111 11111111111111
1111 1000000000001
10111 100000000001
100111 100000E0001
1000001 1000000001
10000011 110000001
100000011 10000001
1000000011 1000001
11111111111 111111
