SO asset/xpm/SO.xpm
WE asset/xpm/WE.xpm
NO asset/xpm/NO.xpm
EA asset/xpm/EA.xpm

F 220,100,0
C 225,30,200

11111111   11111111
10000001   10000001
10000001   10000001
1000000111110000001
1000N001   10000001
10000001   10000001
11111111   11111111
