SO asset/xpm/SKY_BLACK.xpm
WE asset/xpm/SKY_BLACK.xpm
NO asset/xpm/SKY_BLACK.xpm
EA asset/xpm/SKY_BLACK.xpm

F 166,166,166
C 23,22,40

111111111111111111111
11   1000000000000001
101   100000111000001
1001   100000000E0001
10001   1000000000001
100001   100000000001
1111111   11111111111
