SO asset/xpm/SKY_BLACK.xpm
WE asset/xpm/SKY_BLACK.xpm
NO asset/xpm/SKY_BLACK.xpm
EA asset/xpm/SKY_BLACK.xpm

F 166,166,166
C 23,22,40

1111111111111111111111111111111
1000000000000000000000000000001
100W000000000000000000000000001
1000000000111111110000000000001
10000000001      10000000000111
10000000001      100000000001
10000000001      100000000001
10000000001      100000000001
11111111111111111111111111111
