SO asset/xpm/space3.xpm
WE asset/xpm/space3.xpm
NO asset/xpm/space3.xpm
EA asset/xpm/space3.xpm
F 166,166,166
C 23,22,40

11111111111
10000000001
10000000001
10001000001
10002000W01
10001002001
10001000001
10000000001
10000000001
11111111111
